............................................................
.111111..............111111..............111111.............
.122221..............122221..............122221.............
.111111......111111..111111......111111..111111......222222.
............................................................
...........111111..............111111..............111111...
.111111..............111111..............111111.............
.122221..............122221..............122221.............
.111111..............111111..............111111.............
............................................................
............................................................
.111111..............111111..............111111.............
.122221..............122221..............122221.............
.111111......111111..111111......111111..111111......111111.
............................................................
...........111111..............111111..............111111...
.111111..............111111..............111111.............
.122221..............122221..............122221.............
.111111..............111111..............111111.............
............................................................
............................................................
.111111..............111111..............111111.............
.122221..............122221..............122221.............
.111111......111111..111111......111111..111111......111111.
............................................................
...........111111..............111111..............111111...
.111111..............111111..............111111.............
.122221..............122221..............122221.............
.111111..............111111..............111111.............
............................................................
.111111..............111111..............111111.............
............................................................