............................
............................
............................
..........0.................
........1111..1.............
............1...............
..........11................
...........11....11...0.....
.................11..0......
...............11..0........
...............0............
............................