111111111111111111111111111111111111
....................................
..111111..111111..111111..111111..11
111111..111111..111111..111111..1111
..111111..111111..111111..111111..11
....................................
....................................
..111111..111111..111111..111111..11
111111..111111..111111..111111..1111
..111111..111111..111111..111111..11
....................................
111111111111111111111111111111111111